6 6
******
*o...*
*.**.*
*.****
*...e*
******