18 18
******************
*e...............*
*.**************.*
*.****........**.*
*....****.***.**.*
*********.***.**.*
*.........***....*
**.***************
**...........*****
**.*********.*****
**.*****.***.*****
**.*****.***.*****
**.**.**.....*****
**.**.***.********
*..**.***........*
*****.**********.*
*****...........o*
******************
